Nu         = Nu
Reptite    = Reptit
Terrasaur  = Terrasaurus
Kilwala    = Kilwala
Krawlie    = Kriechrich
Hench      = Komplize
Omicrone   = Omikron
Martello   = Martello
Bellbird   = Vlocke
Panel      = Bildschirm
Mammon M.  = Mammon-M.
Blue Imp   = Blau-Imp
Green Imp  = Gift-Imp
Stone Imp  = Stein-Imp
Mud Imp    = Schlamm-Imp
Roly       = Roly
Poly       = Poly
Rolypoly   = Rolypoly
Roly Rider = Rolyreiter
Blue Eaglet= Blau-Adler
Gold Eaglet= Gold-Adler
Red Eaglet = Blut-Adler
Avian Chaos= Avian Chaos
Imp Ace    = Imp-Experte
Bantam     = Bantam
Imp Gnasher= Impkauer
Gnawer     = Gnager
Naga-ette  = Naga-ette
Ruminator  = Ruminator
Octopod    = Oktobirne
Octoblush  = Oktorouge
Octobino   = Oktobino
Zeal       = Kngin Eifer
Fly Trap   = Fliegnfalle
Meat Eater = Fleischfrsr
Man Eater  = Menschnfrsr
Krakker    = Kraacker
Egder      = Klinger
Defunct    = Abgelebt
Departed   = Entschlafen
Deceased   = Verstorben
Decedent   = Abberufen
Macabre    = Makaber
Reaper     = Schnitter
Guard      = Wache
Sentry     = Wachposten
Free Lancer= Freilanzer
Outlaw     = Gesetzlos
Giga Mutant= Giga-Mutant
TerraMutant= TerraMutant
Juggler    = Jongleur
Retinite   = Retinit
Mage       = Zauberer
Blue Shield= Blauschild
Yodu De    = Yodu De
Incognito  = Inkognito
PeepingDoom= LugenderTod
Boss Orb   = Chef-Orb
Side Kick  = Handlanger
Jinn Bottle= Wunderlampe
Evilweevil = Felsbohrer
Tempurite  = Temperapur
Diablos    = Diabolo
Gargoyle   = Gargoyle
Grimalkin  = Grimalkin
T'pole     = Quappe
Croaker    = Quaker
Amphibite  = Amphibisser
Bull Frog  = Ochsnfrosch
Mad Bat    = Flederwahn
Vamp       = Vampir
Scouter    = Spionier
Flyclops   = Fliegklops
Bugger     = Ziefer
Debugger   = Geziefer
Debuggest  = Ungeziefer
Sorcerer   = Hexer
Jinn       = Dschinn
Barghest   = Barghest
Crater     = Krater 
Volcano    = Vulkan
Shitake    = Shitake
Hetake     = Hetake
Rubble     = Schotter
Shist      = Shist
Pahoehoe   = Pahoehoe
Nereid     = Nereid
Mohavor    = Mohavor
Shadow     = Schatten
Base       = Basisch
Acid       = Sauer
Alkaline   = Alkalisch
Ion        = Ion
Anion      = Anion
Thrasher   = Verklopper
Lavos Spawn= Lavos-Laich
Lasher     = Peitscher
Goblin     = Goblin
Ogre       = Ungeheuer
Cave Bat   = Grabflatter
Ogan       = Ogan
Flunky     = Lakai
Groupie    = Groupie
Winged Ape = Fliegeraffe
Cave Ape   = Gruftaffe
Megasaur   = Megasaurus
Omnicrone  = Omnikron
Beast      = Biest
Blue Beast = Blau-Biest
Red Beast  = Blut-Biest
Turret     = Feuerturm
Lizardactyl= Lizardaktyl
Avian Rex  = Avian Rex
Blob       = Blob
Alien      = Eilien
Rat        = Ratte
Gremlin    = Gremlin
Runner     = Sprinter
Proto 2    = Proto 2
Proto 3    = Proto 3
Proto 4    = Proto 4
Bug        = Kriecher
Beetle     = Schwirrer
Goon       = Guhn
Cyrus      = Cyrus
Yakra      = Yakra
Rain Frog  = Regenfrosch
Gato       = Gato
Dragon Tank= Drachnpanzr
Grinder    = Fleischwolf
Golem      = Golem
Synchrite  = Synchrit
Masa       = Masa
Mune       = Mune
Masa & Mune= Masa & Mune
Azala      = Azala
Nizbel     = Nizbel
Nizbel II  = Nizbel II
Slash      = Slash
Flea       = Flea
Flea Plus  = Flea Plus
Dalton     = Dalton
Dalton Plus= Dalton Plus
Mutant     = Mutant 
Metal Mute = Metalldamp
Super Slash= Super-Slash
Ozzie      = Ozzie
Great Ozzie= Super-Ozzie
Heckran    = Heckran
Gigasaur   = Gigasaurus
Leaper     = Springer
Fossil Ape = Fossilaffe
Tank Head  = Panzerkopf
Frog King  = Frosch Rex
Octorider  = Oktoreiter
Zombor     = Zomber  
Display    = Anzeige
Mega Mutant= Mega-Mutant
BlackTyrano= Nachttyrano
Rust Tyrano= Rosttyrano
MotherBrain= Mutterhirn 
Atropos XR = Atropos XR
Cybot      = Cybot
Lavos      = Lavos
Yakra XIII = Yakra XIII
Tubster    = Toaster
Lavos Core = Lavos-Kern
Bit        = Bit
Byte       = Byte
Giga Gaia  = Giga-Gaia
Guardian   = Wachsoldat
Red Scout  = Blutspion
Blue Scout = Blauspion
Laser Guard= Laserwache
Spekkio    = Spekkio
Hexapod    = Hexabirne
Flea?      = Flea?
Roly Bomber= Rolybomber
Golem Boss = Chef-Golem
Johnny     = Johnny
Basher     = Klatscher
Son of Sun = Sonnensohn
R Series   = R-Serie
Magus      = Magus
