Aliza     = Alisa (=Marle's Mutter)
Ayla      = Ayla
Belthasar = Balthasar
Gaspar    = Kaspar
Crono     = Crono
Cyrus     = Cyrus
Dalton    = Dalton
Doreen    = Doriane
Elaine    = Elaine
Epoch     = Epoch
Flea      = Flea
Fritz     = Fritz
Frog      = Frog
Glenn     = Glenn
Janus     = Janus
Kino      = Kino
Lavos     = Lavos
Lavos Bit = (Lavos-)Mittelteil
Lavos Core= Lavos-Kern
Lavos Spawn = Lavos-Laich
Leene     = Lena
Lucca     = Lucca
Magus     = Magus
Mammon Machine = Mammon-Maschine
Marle     = Marle
Melchior  = Melchior
Ozzie     = Ozzie
Robo      = Robo
Schala    = Schala
Slash     = Slash
Tata      = Tata
Toma      = Toma
Zeal      = Eifer
