CHRONO TRIGGER ÜBERSETZUNGSLISTE
--------------------------------
(c) 2003 by ManuLöwe | compiled for Rici (rpg-oase.de), 2007 |
                       angepaßt/korrigiert 2009
                       (Veränderungen sind mit "!" gekennzeichnet)

ITEMS:

Tonic     =Tonic
Mid Tonic =Tonic med.
Full Tonic=Tonic voll
Ether     =Ether
Mid Ether =Ether med.
Full Ether=Ether voll
Elixir    =Elixier
HyperEther=HyperEther
MegaElixir=Megalixier
Heal      =Heilung
Revive    =Belebung
Shelter   =Unterkunft
Power Meal=Kraftmahl
Lapis     =Lapis
Barrier   =Barriere
Shield    =Schild
Power Tab =Kraftpille
Magic Tab =Magiepille
Speed Tab =Hastpille
Petal     =Rotblatt
Fang      =Zahn
Horn      =Horn
Feather   =Feder
Seed      =Samen
Bike Key  =Motorschl.
Pendant   =Amulett
Gate Key  =Torschl.
PrismShard=Prismateil
C. Trigger=C. Trigger
Tools     =Werkzeuge      !
Jerky     =Rauchflsch
Dreamstone=Traumstein
Race Log  =Protokoll
Moon Stone=Mondstein
Sun Stone =Solstein
Ruby Knife=Rubindolch     !
Yakra Key =Yakraschl.
Clone     =Klon
Toma's Pop=Tomas Limo
2 Petals  =2xRotblatt
2 Fangs   =2xZahn
2 Horns   =2xHorn
2 Feathers=2xFeder

---

WAFFEN, RÜSTUNGEN, ACCESSORIES:

Wood Sword=Holzschwrt
Iron Blade=Eisenklnge
SteelSaber=Stahldegen
Lode Sword=Magnetklge
Red Katana=Katana rot
Flint Edge=Flintklnge
Dark Saber=Dunkelklge
Aeon Blade=Ewigklinge
Demon Edge=Teuflsklge
AlloyBlade=Damaszener     !
Star Sword=Sternschw.
VedicBlade=Weda-Klnge
Kali Blade=Kali-Degen
Shiva Edge=Shivaklnge
Bolt Sword=Bolzenklge
Slasher   =Schlitzer
Bronze Bow=Bronzebogn
Iron Bow  =Eisenbogen
Lode Bow  =Magnetbogn
Robin Bow =Robin Hood
Sage Bow  =Weisheit
Dream Bow =Traumbogen
CometArrow=Kometpfeil
SonicArrow=Schall-Pfl
Valkerye  =Valkyrie
Siren     =Sirene
Air Gun   =Luftgewehr
Dart Gun  =Pfeilgewhr
Auto Gun  =Schnllfeur
PicoMagnum=PicoMagnum
Plasma Gun=Plasmagwhr
Ruby Gun  =Rubingewhr
Dream Gun =Traumgewhr
Megablast =Megawucht
Shock Wave=Schckwelle
WonderShot=Wunder
Graedus   =Graedus
Tin Arm   =Zinn-Arm
Hammer Arm=Hammer-Arm
MirageHand=Wunderhand
Stone Arm =Steinhand
DoomFinger=Todesfnger
Magma Hand=Magma-Hand
MegatonArm=Megatonne
Big Hand  =Riesenhand
Kaiser Arm=Kaiser-Arm
Giga Arm  =Giga-Arm
Terra Arm =Terra-Arm
Crisis Arm=Krisen-Arm
BronzeEdge=Brnzeklnge
Iron Sword=Eisenschw.
Masamune  =Masamune
FlashBlade=Blitzklnge
Pearl Edge=Perlmutt
Rune Blade=Runenklnge
BraveSword=Mutschwert
Demon Hit =Ungeheuer
Fist      =Faust
Iron Fist =Eisenfaust
BronzeFist=Erzfaust       !
DarkScythe=DunklSense
Hurricane =Hurrikan
StarScythe=SternSense
DoomSickle=Todessichl
Mop       =Wischmop       !
Bent Sword=Krummklnge
Bent Hilt =Krummheft
Swallow   =Schlucker
Slasher 2 =Schlitzer2
Rainbow   =Regenbogen

Hide Tunic=Fellrobe
Karate Gi =Karateanzg
BronzeMail=BronzeRstg
MaidenSuit=Damenkleid
Iron Suit =Eisenanzug
Titan Vest=Titanenwst
Gold Suit =Gold-Anzug
Ruby Vest =Rubinweste
Dark Mail =DunkleRstg
Mist Robe =Nebelrobe
Meso Mail =Mesopanzer     !
Lumin Robe=Lichtrobe
Flash Mail=FunkelRstg
Lode Vest =Magnetwste
Aeon Suit =Ewigpanzer
ZodiacCape=ZodiakCape     !
Nova Armor=Novapanzer     !
PrismDress=PrismaAnzg
Moon Armor=Mondpanzer     !
Ruby Armor=Rubin-Rstg
RavenArmor=Raben-Rstg
Gloom Cape=BitterCape
White Mail=SchneeRstg
Black Mail=Schw. Rstg
Blue Mail =Blaue Rstg
Red Mail  =Rote Rstg
White Vest=Schneewste
Black Vest=Schw.Weste
Blue Vest =BlaueWeste
Red Vest  =Rote Weste
Taban Vest=TabanWeste
Taban Suit=TabanAnzug
Hide Cap  =Fellkappe
BronzeHelm=Bronzehelm
Iron Helm =Eisenhelm
Beret     =Barett
Gold Helm =Goldhelm
Rock Helm =Felsenhelm
CeraTopper=Cera-Hut
Glow Helm =Leuchthelm
Lode Helm =Magnethelm
Aeon Helm =Ewighelm
Prism Helm=Prismahelm
Doom Helm =Todeshelm
Dark Helm =Dunkelhelm
Gloom Helm=Bitterhelm
Safe Helm =Panzerhelm
Taban Helm=Taban-Helm
Sight Cap =Sichtkappe
Memory Cap=Memo-Kappe
Time Hat  =Zeit-Hut
Vigil Hat =Wachhut
OzziePants=Ozzie-Hose
Haste Helm=Hast-Helm
R'bow Helm=RegnbgHelm
MermaidCap=Nixenkappe

Bandana   =Stirnband
Ribbon    =Schleife
PowerGlove=Handschuhe     !
Defender  =Verteidigr
MagicScarf=Magieschal
Amulet    =Talisman       !
Dash Ring =Sprintring
Hit Ring  =Schlagring
Power Ring=Kraftring
Magic Ring=Magiering
Wall Ring =ReflexRing
SilverErng=SilbrOhrrg
Gold Erng =Gold-Ohrrg
SilverStud=Silbernadl
Gold Stud =Goldnadel
SightScope=Sichtfeld
Charm Top =Superfalle
Rage Band =Zorn-Band
FrenzyBand=Zorn-Band2
Third Eye =Dritt.Auge
Wallet    =Geldbeutel
GreenDream=Baumtraum
Berserker =Berserker
PowerScarf=Kraftschal
Speed Belt=Hast-Gurt
Black Rock=Schw.stein
Blue Rock =Blaustein
SilverRock=Silbrstein
White Rock=Weisstein
Gold Rock =Goldstein
Hero Medal=Held.amltt
MuscleRing=Muskelring
Flea Vest =Flea-Weste
Magic Seal=Mag.Siegel
Power Seal=KrftSiegel
Relic     =Relikt
SeraphSong=SeraphLied
Sun Shades=Son.Schirm
PrismSpecs=Prsmabrlle

---

TECHS:

Cyclone    =Zyklon
Slash      =Stich
Lightning  =Gewitter
Spincut    =Drehschnitt
Lightning2 =Gewitter 2
Life       =Leben
Confuse    =Verwirren
Luminaire  =Leuchten
Aura       =Aura
Provoke    =Reizen
Ice        =Eis
Cure       =Kraft
Haste      =Hast
Ice 2      =Eis 2
Cure 2     =Kraft 2
Life 2     =Leben 2
Flame Toss =Feuerwurf
Hypno Wave =Hypnowelle
Fire       =Feuer
Napalm     =Napalm
Protect    =Schutz
Fire 2     =Feuer 2
Mega Bomb  =Megabombe
Flare      =Fackel
RocketPunch=Raketpunch
Cure Beam  =Kraftstrahl
Laser Spin =Laserwirbel
Robo Tackle=RoboAngriff
Heal Beam  =Heilstrahl
Uzzi Punch =Uzzi-Punch
Area Bomb  =Sektorbombe
Shock      =Schock
Slurp      =Zunge
Slurp Cut  =Schlagzunge
Water      =Wasser
Heal       =Heilen
Leap Slash =Drehsprung
Water 2    =Wasser 2
Frog Squash=Quakendruck
Kiss       =Schmatzer
Rollo Kick =Rollo-Kick
Cat Attack =Katzkratz
Rock Throw =Wurfbeben
Charm      =Venusfalle
Tail Spin  =Drehschwanz
Dino Tail  =Dinosaurier
Triple Kick=Dreierkick
Lightning2 =Gewitter 2
Dark Bomb  =Dkl. Bombe
Magic Wall =Magiewand
Dark Mist  =Dkl. Nebel
Black Hole =Schw. Loch
DarkMatter =A.Materie
Aura Whirl =Aurawirbel
Ice Sword  =Eisschwert
Ice Sword 2=Eisschwert2
Fire Whirl =Feuerwirbel
Fire Sword =Feuerklinge
Fire Sword2=Feuerkl. 2
Rocket Roll=Raketrolle
Max Cyclone=Max-Zyklon
Super Volt =Supervolt
X Strike   =X-Schlag
SwordStream=Wasserfall
Spire      =Donnerstab
Drill Kick =Drill-Kick
Volt Bite  =Voltzahn
Falcon Hit =Falkschlag
Antipode   =Antipode
Antipode 2 =Antipode 2
Antipode 3 =Antipode 3
Aura Beam  =Aurastrahl
Ice Tackle =Eisangriff
Cure Touch =Kraftsegen
Ice Water  =Eiswasser
Glacier    =Gletscher
Double Cure=Doppelkraft
Twin Charm =Doppelfalle
Ice Toss   =Eiswurf
Cube Toss  =Quaderwurf
Fire Punch =Feuerpunch
Fire Tackle=Feuergriff
DoublevBomb=Doppelbombe
Flame Kick =Flammenkick
Fire Whirl =Feuerwirbel
Blaze Kick =Glutkick
Blade Toss =Klingenwurf
Bubble Snap=Platzblase
Cure Wave  =Kraftwelle
Boogie     =Boogie
Spin Kick  =Drehkick
Beast Toss =Biestwurf
Slurp Kiss =Schlecker
Bubble Hit =Schlagblase
Drop Kick  =Wurfkick
Red Pin    =Rote Nadel
Line Bomb  =Linienbombe
Frog Flare =Quakfackel
Delta Force=Deltamacht
Lifeline   =Lebenslinie
Arc Impulse=Bogenimpuls
Final Kick =Finalkick
Fire Zone  =Feuersektor
Delta Storm=Deltasturm
GatlingKick=Kanonenkick
Triple Raid=3fachSchlag
Twister    =Tornado
3D Attack  =3D-Angriff
DarkEternal=Ewig Dunkel
Omega Flare=Omegafackel
Spin Strike=Schlagtanz
PoyozoDance=Poyozo-Tanz
Grand Dream=Riesentraum

---

GEGNER:

Nu         = Nu
Reptite    = Reptit
Terrasaur  = Terrasaurus
Kilwala    = Kilwala
Krawlie    = Kriechrich
Hench      = Komplize
Omicrone   = Omikron
Martello   = Martello
Bellbird   = Vlocke
Panel      = Bildschirm
Mammon M.  = Mammon-M.
Blue Imp   = Blau-Imp
Green Imp  = Gift-Imp
Stone Imp  = Stein-Imp
Mud Imp    = Schlamm-Imp
Roly       = Roly
Poly       = Poly
Rolypoly   = Rolypoly
Roly Rider = Rolyreiter
Blue Eaglet= Blau-Adler
Gold Eaglet= Gold-Adler
Red Eaglet = Blut-Adler
Avian Chaos= Avian Chaos
Imp Ace    = Imp-Experte
Bantam     = Bantam
Imp Gnasher= Impkauer
Gnawer     = Gnager
Naga-ette  = Naga-ette
Ruminator  = Ruminator
Octopod    = Oktobirne
Octoblush  = Oktorouge
Octobino   = Oktobino
Zeal       = Kngin Eifer
Fly Trap   = Fliegnfalle  !
Meat Eater = Fleischfrsr
Man Eater  = Menschnfrsr
Krakker    = Kraacker
Egder      = Klinger
Defunct    = Abgelebt     !
Departed   = Entschlafen
Deceased   = Verstorben
Decedent   = Abberufen
Macabre    = Makaber
Reaper     = Schnitter
Guard      = Wache
Sentry     = Wachposten
Free Lancer= Freilanzer
Outlaw     = Gesetzlos
Giga Mutant= Giga-Mutant
TerraMutant= TerraMutant
Juggler    = Jongleur
Retinite   = Retinit
Mage       = Zauberer
Blue Shield= Blauschild
Yodu De    = Yodu De
Incognito  = Inkognito
PeepingDoom= LugenderTod  !
Boss Orb   = Chef-Orb
Side Kick  = Handlanger
Jinn Bottle= Wunderlampe
Evilweevil = Felsbohrer   !
Tempurite  = Temperapur
Diablos    = Diabolo
Gargoyle   = Gargoyle
Grimalkin  = Grimalkin
T'pole     = Quappe
Croaker    = Quaker
Amphibite  = Amphibisser
Bull Frog  = Ochsnfrosch
Mad Bat    = Flederwahn
Vamp       = Vampir
Scouter    = Spionier
Flyclops   = Fliegklops
Bugger     = Ziefer
Debugger   = Geziefer
Debuggest  = Ungeziefer
Sorcerer   = Hexer
Jinn       = Dschinn
Barghest   = Barghest
Crater     = Krater 
Volcano    = Vulkan
Shitake    = Shitake
Hetake     = Hetake
Rubble     = Schotter
Shist      = Shist
Pahoehoe   = Pahoehoe     !
Nereid     = Nereid
Mohavor    = Mohavor
Shadow     = Schatten
Base       = Basisch      !
Acid       = Sauer
Alkaline   = Alkalisch    !
Ion        = Ion
Anion      = Anion
Thrasher   = Verklopper
Lavos Spawn= Lavos-Laich
Lasher     = Peitscher
Goblin     = Goblin
Ogre       = Ungeheuer
Cave Bat   = Grabflatter
Ogan       = Ogan
Flunky     = Lakai
Groupie    = Groupie
Winged Ape = Fliegeraffe
Cave Ape   = Gruftaffe
Megasaur   = Megasaurus
Omnicrone  = Omnikron
Beast      = Biest
Blue Beast = Blau-Biest
Red Beast  = Blut-Biest
Turret     = Feuerturm
Lizardactyl= Lizardaktyl
Avian Rex  = Avian Rex
Blob       = Blob
Alien      = Eilien
Rat        = Ratte
Gremlin    = Gremlin
Runner     = Sprinter
Proto 2    = Proto 2
Proto 3    = Proto 3
Proto 4    = Proto 4
Bug        = Kriecher
Beetle     = Schwirrer
Goon       = Guhn
Cyrus      = Cyrus
Yakra      = Yakra
Rain Frog  = Regenfrosch
Gato       = Gato
Dragon Tank= Drachnpanzr
Grinder    = Fleischwolf
Golem      = Golem
Synchrite  = Synchrit
Masa       = Masa
Mune       = Mune
Masa & Mune= Masa & Mune
Azala      = Azala
Nizbel     = Nizbel
Nizbel II  = Nizbel II
Slash      = Slash
Flea       = Flea
Flea Plus  = Flea Plus
Dalton     = Dalton
Dalton Plus= Dalton Plus
Mutant     = Mutant 
Metal Mute = Metalldamp
Super Slash= Super-Slash
Ozzie      = Ozzie
Great Ozzie= Super-Ozzie
Heckran    = Heckran
Gigasaur   = Gigasaurus
Leaper     = Springer
Fossil Ape = Fossilaffe
Tank Head  = Panzerkopf
Frog King  = Frosch Rex
Octorider  = Oktoreiter
Zombor     = Zomber  
Display    = Anzeige
Mega Mutant= Mega-Mutant
BlackTyrano= Nachttyrano
Rust Tyrano= Rosttyrano
MotherBrain= Mutterhirn 
Atropos XR = Atropos XR
Cybot      = Cybot
Lavos      = Lavos
Yakra XIII = Yakra XIII
Tubster    = Toaster
Lavos Core = Lavos-Kern
Bit        = Bit
Byte       = Byte
Giga Gaia  = Giga-Gaia
Guardian   = Wachsoldat
Red Scout  = Blutspion
Blue Scout = Blauspion
Laser Guard= Laserwache
Spekkio    = Spekkio
Hexapod    = Hexabirne
Flea?      = Flea?
Roly Bomber= Rolybomber
Golem Boss = Chef-Golem
Johnny     = Johnny
Basher     = Klatscher
Son of Sun = Sonnensohn
R Series   = R-Serie
Magus      = Magus

---

NAMEN, MISC:

Aliza     = Alisa (=Marle's Mutter)
Ayla      = Ayla
Belthasar = Balthasar
Gaspar    = Kaspar
Crono     = Crono
Cyrus     = Cyrus
Dalton    = Dalton
Doreen    = Doriane
Elaine    = Elaine
Epoch     = Epoch
Flea      = Flea
Fritz     = Fritz
Frog      = Frog
Glenn     = Glenn
Janus     = Janus
Kino      = Kino
Lavos     = Lavos
Lavos Bit = (Lavos-)Mittelteil
Lavos Core= Lavos-Kern
Lavos Spawn = Lavos-Laich
Leene     = Lena
Lucca     = Lucca
Magus     = Magus
Mammon Machine = Mammon-Maschine
Marle     = Marle
Melchior  = Melchior
Ozzie     = Ozzie
Robo      = Robo
Schala    = Schala
Slash     = Slash
Tata      = Tata
Toma      = Toma
Zeal      = Eifer

Blackbird: Düstervogel
Black Omen: Düsteromen
Lock: Siegel
Ocean Palace: Seepalast
Stop: Stop
Strike: Stoß
Vigor: Stärke
Zeal: Eifer (Achtung, Gegner Zeal = Kngin Eifer; Orte: Zeal Palace = Königl. Palast)

---

MENÜ:

PWR: ATK
SPD.: GSW.
HIT: TRF (Treffer)
EV.: AW. (Ausweichen)
STAM.: AUSD. (Ausdauer)
M DEF: M VRT (Verteidigung)

---

CREDITS:

Advertisement		= Reklame
Battle Plan		= Kampfplanung
Battle Program		= Kampfprogramm
Character Design	= Figurendesign
Character Graphic	= Figurengrafik
Director		= Regie
Effect Graphic		= Graf. Effekte
Event Plan		= Ereignisse
Executive Producer	= Ausf. Produzenten
Field Graphic		= Kartengrafik
Field Plan		= Kartenplanung
Field Program		= Kartenprogramm
Graphic Director	= Leitung Grafik
Main Program		= Hauptprogramm
Map Design		= Kartendesign
Menu Program		= Menueprogramm
Monster Graphic		= Gegnergrafik
Music			= Musik
Producer		= Produktion
Remake Staff		= US Engl. Version
Sound Effect		= Toneffekte
Sound Engineer		= Tontechnik
Sound Program		= Musikprogramm
Story Plan		= Storyplanung
Supervisor		= Produkt.Leitung
System Engineer		= Systemtechnik
Test Coordinator	= Test Koordination
Translator		= US Engl. Version
Visual Program		= Grafikprogramm
Worldmap Program	= Kartenprogramm
